111111111
10P011111
111C00001
100000001
1E1C00001
111111111