11111111111111111111
100P0000000000000001
10000000000000000001
10000000000000000001
1000000C000000000001
10000000000000000001
10000000000000000001
10000000000000000001
10000000000000000E01
11111111111111111111