11111111111111
10000P00000001
10000000000001
11111101111111
10000000000001
100000C0000001
1000000000E001
11111111111111