111111
100P01
110001
10C0E1
111111