11111111111111111
100P000111110C001
1100110000C010001
1C0EC000011100001
11111111111111111