11111111
100P0001
110011001
1C0EC001
11111111