111111
100P01
110001
1C00C1
111111